------------------------------------------------------------------------------------------------------------------------
------------------------------------------------------------------------------------------------------------------------
------------------------------------------------------------------------------------------------------------------------
------------------------------------------------------------------------------------------------------------------------
------------------------------------------------------------------------------------------------------------------------
------------------------------------------------------------------------------------------------------------------------
------------------------------------------------------------------------------------------------------------------------
-5--------------------------------------------------------------------------------------------------5-------------------
-5--------------------------------------------------------------------------------------------------5-------------------
-5--------------------------------------------------------------------------------------------------5-------------------
-5--------------------------------------------------------------------------------------------------5-------------------
-5--------------------------------------------------------------------------------------------------5-------------------
-5--------------------------------------------------------------------------------------------------5-------------------
-5--------------------------------------------------------------------------------------------------5-------------------
-5--------------------------------------------------------------------------------------------------5-------------------
-5-------------------------------------222223-------------------------------------------------------5-------------------
-5--------------------------------------------------------------------------------------------------5-------------------
-5--------------------------------------------------------------------------------------------------5-------------------
-5----------------------4---------------------------------------------------------------------------5-------------------
111111111111111111111111111111111111111111111111111111111111111111111111111111111111111111111111111111111111111111111111